..................
............T.....
S000T...T....000..
..T000000T..T0T0..
...T...T000000.0..
..........T....0..
...............0..
...............0..
...........00000..
...........B......X